NO textures/wall_1.xpm
SO textures/wall_2.xpm
WE textures/wall_3.xpm
EA textures/wall_4.xpm
F 220,100,0
C 50,50,50
1111111111111111111111111111111111111111111
1000000000000000000000000000000000000000001
1000000111110000000000000000000000000000001
1000000100010000000000000000000000000000001
1000000100010000000000000000000000000000001
1000000111110000000000000000000000000000001
1000000000000000000000000000000000000000001
1000000000000000000000000001010000000000001
1000000000000000000000000000000010000000001
1001111110000000000000000000000000000000001
1000000000000000000000000000000000000000001
1001111110000000000000000000000000000000001
100000000000000000000000000000000N000000001
1111111111111111111111111111111111111111111