NO textures/wall_1.xpm
SO textures/wall_2.xpm
WE textures/wall_3.xpm
EA textures/wall_4.xpm
F 220,100,0
C 50,50,50
111111111
100000001
100000001
100E00001
100000001
111111111