NO ./textures/north_texture.xpm
SO ./textures/south_texture.xpm
WE ./textures/west_texture.xpm
EA ./textures/east_texture.xpm
F 0,80,120
C 0,20,60
111111111111111111111111111111
100000000001000000000000000001
101111111101011111111111111101
100000000101000000000000000101
111110111101110111111111110101
100010000001000100000000010101
101011111101011011111110010101
101000000001010000000010010101
101011111111010111111010010101
101010000001010100001010010101
101010111101010101101010010101
101010100001010101001010010101
101010101111010101011010010101
101010100000010101000010010101
101010111111110101111110010101
101010000000000100000000010101
101011111111111011111111110101
101000000000000000000000000101
101111111111111111111111111101
100000N00000000000000000000001
111111111111111111111111111111