NO textures/wall_1.xpm
SO textures/wall_2.xpm
WE textures/wall_3.xpm
EA textures/wall_4.xpm
F 0,60,100
C 0,10,40
11111111111111111111111111
10000000000000000000000001
10010001000100010001000101
10000000000000000000000101
10010001000100010001000101
10000000000000000000000001
10010001000100010001000101
10000000000000000000000001
10010001000100010001000101
10000000000000000000000001
10000000000000000000000001
10000000N00000000000000001
10000000000000000000000001
10010001000100010001000101
10000000000000000000000001
11111111111111111111111111