NO textures/wall_1.xpm
SO textures/wall_2.xpm
WE textures/wall_3.xpm
EA textures/wall_4.xpm
F 0,100,140
C 0,30,80
1111111111111111111111111
1000000000000000000000001
1011111111111111111111101
1010000000000000000000101
1010111111111111111110101
1010100000000000000100101
1010101111111111110100101
1010101000000000010100101
1010101011111110010100101
1010101010000010010100101
1010101010N00010010100101
1010101010111110010100101
1010101010000000010100101
1010101011111111110100101
1010101000000000000100101
1010101111111111111100101
1010100000000000000000101
1010111111111111111111101
1010000000000000000000001
1011111111111111111111101
1000000000000000000000001
1111111111111111111111111